NO ./textures/north.xpm
SO ./textures/south.xpm
WE ./textures/west.xpm
EA ./textures/east.xpm

F 220,100,0
C 225,30,0

11111111111111111111111111111111111111
10000000001100000000000000000000000001
10000000000011000000000000000000000001
10000000000000110000000000000000000001
10000000000000001100000000000000000001
10000000000000000011000000000000000001
10000000000000000000110000011111000001
10000000000000000000000000011111000001
10000000000000000000000000011111000001
1000000001000000E000000000011111000001
10000000111000000000000000000000000001
10000001111100000000001111111100000001
10000011111110000000111111111111000001
10000111111111000011111111111111110001
10000011111110001111111111111111111101
10000001111100000011111111111111110001
10000000111000000000111111111111000001
10000000010000000000001111111100000001
10000000000000000000000000000000000001
11111111111111111111111111111111111111